@#/_/mkha' 'gro snying thig/ mkha' 'gro sngags kyi lde mig/ Ключ-мантри Дакіні

OM A HUM HI MA HA RI NI SA RA TSA HRI YA HUM DZA
OM HA RI NI SA HUM — Це збирає і накопичує багатство
HA RI NI SA RA TSA NDRI YA — Ці вісім досягаються через практику тоґалу (прямої трансценденції) Дакіні
HA RI NI SA RI PA — Це породжує духовне тепло
HA RI NI SA HITAM HURU SVAHA - Для умиротворення та накопичення заслуг
HA RI NI SA PUTI KURU SVAHA - Для збільшення
HA RI NI SA PA SHAM KURU SVAHA - Для розширення можливостей
HA RI NI SA CHA MO RA YA SO - За гнівну діяльність
HA RI NI SA CHA MO KHUG KHUG NO THONG - Щоб взяти мудру під контроль
HA RI NI SA CHU BUR MIG GI GO SOL -  Якщо хтось хоче побачити Дакінь
HA RI NI SA PU TRA SI RI BRU NI RAKSHA RAKSHA LAM RUNG NI - Щоб оживити дитину
HA RI NI SA CHOGA KUN ZLOG ZLOG - Щоб відбити всі перешкоди
TRI U TSA TA YA PHAT - Для відсічі ворогам і загороджувальним силам

@#/_/klong chen 'od gsal snying thig/ rdo rje gsung/ Ваджрні Склади

/rgya gar gyi skad/

A    AH   AM   BA   BAM  BHA  CA   :
DA   DHA  DE   DHE  DHI  DU   DHU  :
E    GA   GHA  GHAM :    :    :    :
HA   HAM  HUM  I    JA   JRA  :    :
KA   KHA  KHE  KSHI KTA  KU   :    :
LA   LAM  LI   LIM  :    :    :    :
MA   ME   MI   MO   :    :    :    :
NA   NAM  NDA  NYA  OM   :    :    :
PA   PAN  PHA  PHAT :    :    :    :
RA   RAM  RE   RI   RTA  RU   RYA  :
SA   SHA  SHRI SI   SPA  STA  SU   SVA
TA   TE   THA  TSA  TVA  TU   :    :
VA   YAM  YA   :    :    :    :    :

/o rgyan gyi skad/

BE   BHE  BHUN BRUM CI   DZA  GHU  :
GAR  HI   JNA  :    KETA KI   KO   :
KUN  LEM  NRI  SIR  NTA  PRE  SHU  YE

/mkha' 'gro'i skad/

BAM  HRI  HRIH HRIM HUNG TRAM PHEM PHEIM

@#/_/klong chen snying thig/ rdo rje gsung/

/bod gyi skad/

A

KA   KHA  GA   GHA  ṄA
CA   CHA  JA   JHA  ÑA
ṬA   ṬHA  ḌA   ḌHA  ṆA
TA   THA  DA   DHA  NA
PA   PHA  BA   BHA  MA
YA   VA   RA   LA   :
ŚA   ṢA   SA   HA   KṢA
I    Ī    U    Ū    :
E    AI   O    AU   :

klong chen 'od gsal snying thig/ sa bon bi ja/

/rgya gar gyi skad/ ngag kyi yi ge/ Санскрит

Простір:
E: Вічність.
KA: Фундаментальний простір Акаша.
KHA: Рухлива енергія простору.
KAM: Простір-елемент.
HAM: Порожнеча простору.

Вітер:
VA: Вітер.
YA: Енергія вітру.
YAM: Вітер-елемент.
CA: Обертання.
GA: Потік.
DU: Дія.
DHU: Рух.
TE: Сила.
JA: Народження.
TSA: Сяйво.
KTA: Перетворення.

Вогонь:
HA: Подих.
RA: Енергія вогню.
RAM: Вогонь-елемент.
AM: Співчуття.
MA: Мати.
DA: Дарування.
MO: Блаженство.
I: Жіноча енергія.
LI: Рухливість.
LIM: Танець.
SI: Екстаз.
SA: Вічна сила.
SPA: Дотик.
SHA: Мир.
SHRI: Слава.
SU: Добро.
RTA: Порядок.

Земля:
MI: Прояв землі.
KU: Стабільна основа.
LA: Поверхня землі.
LAM: Земля-елемент.
TA: Захист тиші.
THA: Міцність.
TU: Захист руху.
PA: Захист.
PAN: Захистник.
STA: Стабільність.

Вода:
BA: Енергія води.
BAM: Вода-елемент.
ME: М'яка вода.
NA: Очищувальна вода.
KSHI: Захистне руйнування.
PHA: Вибух.
PHAT: Руйнування.

Мислення:
BHA: Милосердний.
DHI: Мудрість.
NYA: Знання.
JRA: Перемога.
AH: Безмежність.
DE: Божественність.
DHE: Всерозумність.
DHA: Непорушне.
TVA: Душа.

Звукові:
GHA: Реверберація.
GHAM: Глибина звуку.
KHE: Енергія звуку.
RU: Звук.

Світлові:
KI: Енергія світла.
RI: Чиста ясність.
RE: Динамічна енергія світла.
RYA: Динамічна ясність.

Структурні:
NAM: Поклоніння.
OM: Початок.
A: Мовлення.
HUM: Трансформація.
SVA: Самість.
NDA: Завершення.

/o rgyan gyi skad/ rang byung yi ge/ Удіяна

KI: Ясність.
KUN: Універсальність.
KO: Простір.
BE: Благословення.
BHE: Благословенна трансорфмація.
BHUN: Земля.
BRUM: Броня.
CI: Свідомість.
DZA: Дія.
GHU: Резонанс.
GAR: Міць.
HI: Радість.
JNA: Мудрість.
KETA: Темрява.
LEM: Потік.
NRI: Герой.
NTA: Завершення.
PRE: Початок.
SHU: Мир.
SIR: Сяйво.
YE: Вічність.

/mkha' 'gro'i skad/ mkha' 'gro'i gung bya/ Дакіні

BAM: Милосердя.
HRI: Співчуття.
HRIH: Серце.
HRIM: Чисте співчуття.
HUNG: Фіксація.
PHEM: Руйнування.
PHEIM: Очищення.
TRAM: Насіння Ратнасабхави.

@#/_/klong chen 'od gsal snying thig/ sngags kyi mchod pa/ Ваджрні Слова

Просвітлення:
DHARMA: Вогнестійкі істини основи.
DHATU: Захищена нерушима основа.
BODHI: Пробудження.
CITTA: Мислення.
BODHI CITTA: Просвітлений розум.
DHARMA DHATU: Сфера Істинної Реальності.
KAYA: Тіло.
NIRMA: Еманаційне тіло.
SAMBHO: Тіло насолоди.
VAJRA: Нерушима природа.
JNANA: Знання.

Гуру, Деви і Дакіні:
RATNA: Дорогоцінність, три коштовності.
MAHA: Великий, величезний, універсальний.
SARVA: Всі, тотальність.
TATHAGATA: Так Прийшовший, будда.
GURU: Вчитель; гуру-йога, благословення.
MANDARAVA: Мандарава; довголітня дакіні.
DEVA: Бог, божество; небесний аспект.
DAKINI: Небесна танцівниця; енергія мудрості.

Стани:
ABHISHYNTSA: Освячений, помазаний; ініціація.
ARHATE: Вартий; святі.
AYU: Життя; довголіття.
BHAGAVATE: Володар; благословенний.
PUNYE: Заслуга; доброчесність.
SAMYAK SAMBUDDHAYA: Повністю просвітлений; ідеальне пробудження.
SIDDHI: Здобуток; надприродні сили.
TEJAS: Сяйво; блиск просвітлення.
VIDYA: Знання; магія, наука.

Ритуали:
AVARANA: Завадь.
AVESHAYA: Увійди.
GUHYA: Сховай.
KAHI: Прийми.
PRATITSA: Встанови.
RAKSHA: Охороняй.
SAMAYA: Обіцяй.
SAMKRAMANA: Передай.
TISHTA: Стань.
VISHUDDHA: Очисти.

Офіри:
AMRITA: Нектар.
RAKTA: Кров.
BALIMTA: Жертва.
PUSHPE: Квітка.
DHUPE: Дим.
ARGHAM: Внутрішня вода.
PADYAM: Зовнішня вода.
ALOKE: Світло.
RASA: Смак.
SPARSHE: Дотик.
RUPA: Форма.
GANDHE: Аромат.
SHAPTE: Звук.
PANCA: П'ять.
PUJA: Пошана.
GANACAKRA: Зібрання.
VIJÑĀNA: Свідомість.

Захисники:
BHUMI: Земля.
EKAJATI: Одноока; захисниця.
HARINITSA: Граційна; дакіні.
DHARMA PALA: Захисник дхарми.
KSHETRA PALA: Господар поля.
LOKA PALA: Захисник світу.
MAHA KALA: Великий Чорний; захисник.
PRAMOHA: Марення; ілюзія.
RAHULA: Затмення; демон.
SAPARIVA: Родина; свита.
SHRI: Слава; благословення.
SUPATITA: Надзвичайний; танцюючий.

Рідкісні:
AGRAHI: Приймач.
AYURJNANA: Довголітня мудрість.
DROOM: Барабан.
GAGANA: Небо.
GIRTI: Гімн.
HO: Підтвердження.
IMAM: Вказівка.
KARAM: Робота.
LASYE: Грація.
LHAN: Найвищий.
MALYE: Вінець.
MAMA: Привласнення.
MANDARAVA: Мандарава.
MANDOPA: Коло.
MIRTANGI: Дзеркало.
NA: Заперечення.
NAIVIDYA: Їжа; пожертва.
NAMA: Ім'я; поклоніння.
NATE: Кланяйся; поклон.
PATI: Господар; лорд.
PEM: Лотос; любов (від PEMA).
PHALA: Плід; результат.
PRE: Перед; префікс.
PUHO: Надмірний; повний.
PURUSHAYA,Людина; істота.
SUKHA: Щастя; блаженство.
TEYATA: Так; таким чином.
TRAG: Коза; жертва.
TSE: Життя; час.
UCISHTA: Залишки; трансгресія.

@#/_/klong chen 'od gsal mkan' 'gro snying thig/ klong chen nyer lnga'i snying po/ 25 Тіглє Самантабхадри

karma raksha ghi ham ti
bhe ga ra na so ghadlim
pu ka ri la bha dhu tri
ram pa ka la sa mi khyem
mattan pha pher rasmi ti

kha ta re ka sa miklam
a ke ra na bhe tsakshva
ya ri mu ta sa ghu li
ya sim ra lam ba la ya
ma ma ko lin sa manta

gha rim yam pa ri mam ti
bu ga singha pa gha lam
ra mi pi pi khe ta pa
bi khu ma la pa tam ke
sa ma nyi wa dhe ra pa

vajra sattva di dho me
ghe ba su gharma ma yai
dharmā pa ti sa ghu li
rasmi sa mā khargad tshi
ru pa sa mi mi ta lam

nja tik bha yam ka li sa
gha tshi pa la sa i tam
karma e ka ma nu sā
san tri ma ma karma ta
nja la khe bha ki li sa

